Hi admin?	hi, ada yang bisa kami bantu?
Assalamu'alikum?	wa'alaikumsalam, ada yang bisa kami bantu?
Hallo?	hallo, ada yang bisa kami bantu?
Stok ada min?	ada kak, bisa langsung pesan ya.
Variant wanginya apa aja min?.	ada dobha , bakarat, lovely
Bisa COD min?	bisa kak, langsung pesan aja?
Variant wangi yang favorit apa min?	ada lovely, bakarat. i'm in school right now.
Apakah ini tanpa alkohol min?.	iya kak, bisa digunakan untuk sholat juga?
Wanginya tahan lama min?	iya kak, bisa seharian .
Harganya berapa min?.	tergantung varian kak, bisa cek katalog ya kak?
Apakah bisa di mix varian wanginya min?	bisa kak, langsung pesan aja ya.
Varian yang cocok untuk cewek apa min?.	ada lovely kak.
Varian yang cocok untuk cowok apa min?.	ada bakarat kak.
Bisa negi gak min?.	gak bisa kak, udah diskon.
Saya sudah pesan ya kak	baik kak, akan segara kami packing
Wanginya ada yang tidak menyengat gak min?	ada kak, buat cewek lovely dan cowok bakarat.
Pesan sekotak bisa min?.	bisa kak, bisa di mix juga?
di semprot apa di oles min?	mayoritas di oles kak?
Apakah parfume ini halal min?	Halal kak, sudah ada logo halalnya.
Apakah sudah terdaftar di BPOM min.	iya, sudah kak
Produknya bikin iritasi gak min?	iaman kak, sejauh ini belum ada laporan iritasi kulit.
Wanginya cocok buat nongkrong gak min?.	cocok banget kak, bisa di pake di acara apapun?